{
  "data": [
    "111111111",
    "101001001",
    "100100001",
    "100101001",
    "100000001",
    "100110001",
    "100100001",
    "100100001",
    "111111111"
  ],
  "player_start": [1, 1]
}
