{
  "data": [
    "11111111",
    "10100101",
    "10010001",
    "10010001",
    "10010001",
    "10011001",
    "10010001",
    "11111111"
  ]
}
