{
  "data": [
    "1111111111111",
    "1010010000101",
    "1001000000101",
    "1001010001101",
    "1000000000001",
    "1001100011101",
    "1001000010101",
    "1001000010001",
    "1001000010001",
    "1001000010001",
    "1001000010001",
    "1001000010001",
    "1111111111111"
  ],
  "player_start": [
    1,
    1
  ]
}
